11111111111111111111111
1PCCCCCCCCCCCCCCCCCCCE1
11111111111111111111111