11111111111111111111111111111111111111
1P000000000000000000000000000000000001
10000000000000000C000000000000C000E001
10000000000000000000000000000000000001
10101010101010101010000010C00001111111
10000000000000000000001011111111111111
100000000000C0000000001011111111111111
100000100000C0000000001011111111111111
100000000001C1000000001011111111111111
100000000001C1000000001011111111111111
100000000001C1000000001011100001111111
100000000001C1000000001011101100111111
10000000000111000000001110110111111111
11111111111111111111111111111111111111