1111111111  
1111111111
1111111111
1111PCE111
1111111111