11111111111111111111111111111111111111111
1P000000000000000000000000000000000000001
10000000000000000C000000000000000C000E001
10000000000000000000000000000000000000001
10101010101010101010000010000C00001111111
10000000000000000000001011111111111111111
100000000000C0001000001011111111111111111
100000100000C00010000001011111111111111111
100000000001C1000000001011111111111111111
10000000000111000000001011111100000111111
10000000000111000000001011111100C00111111
10000000000111000000001011111100000111111
11111111111111011100001111111111111111111
11111111111111111111111111111111111111111

C=-- E=-- 

P or 0