1111 1111
10000P001
11111CE11
111111111