11111111111
11111100011
11000000001
11000000001
1100CCC1111
11000E0CC01
10000000001
10000P00001
11111111111
11111111110